50 30
-10 602
1145 45
00 00 00 00 00 00 00 00 00 00 00 00 00 00 00 00 00 00 00 00 00 00 00 00 00 00 00 00 00 00 00 00 00 00 00 00 00 00 00 00 00 00 00 00 00 00 00 00 00 00
00 02 02 02 02 02 02 02 02 02 03 03 03 03 03 02 02 02 02 02 02 03 03 03 03 03 03 03 03 03 03 03 03 03 03 03 03 03 03 03 03 03 03 03 03 03 03 03 03 09 
00 02 02 02 02 02 02 02 03 03 03 03 03 03 03 03 02 02 02 02 02 03 10 10 10 10 10 10 10 10 10 10 10 10 10 10 10 10 10 10 10 10 10 10 10 10 10 10 10 10 
00 02 02 02 02 02 02 02 03 10 10 10 10 10 10 03 02 02 02 02 02 03 10 10 10 10 10 10 10 10 10 10 10 10 10 10 10 10 10 10 10 10 10 10 10 10 10 10 10 10 
00 02 03 03 03 03 03 03 03 10 10 10 10 10 10 03 03 03 03 03 03 03 10 10 10 03 03 03 03 03 03 03 03 03 03 03 03 03 03 03 03 03 03 10 10 03 03 03 03 09 
00 03 03 10 10 10 10 10 10 10 10 10 10 10 10 10 10 10 10 10 10 10 10 10 10 03 03 03 03 02 02 02 02 02 02 03 03 02 02 02 02 03 03 10 10 03 02 02 02 00 
00 03 03 10 10 10 10 10 10 10 10 10 10 10 10 10 10 10 10 10 10 10 10 10 10 03 03 02 02 02 02 02 02 02 02 02 02 02 02 02 02 02 03 10 10 03 02 02 02 00 
00 03 03 10 10 03 03 03 03 10 10 10 10 10 10 03 03 03 03 03 03 03 10 10 10 03 03 02 02 02 02 02 02 02 02 02 02 02 02 02 02 02 03 10 10 03 02 02 02 00 
00 02 03 10 10 03 02 02 03 10 10 10 10 10 10 03 02 02 02 02 02 03 10 10 10 03 03 02 02 02 02 02 02 02 02 02 02 02 02 02 02 02 03 10 10 03 02 02 02 00 
00 02 03 10 10 03 02 02 03 03 03 03 03 03 03 03 02 02 02 02 02 03 10 10 10 03 02 02 02 02 02 02 02 02 02 02 02 02 02 02 02 02 03 10 10 03 02 02 02 00  
00 02 03 10 10 03 02 02 02 02 02 02 02 02 02 02 02 02 02 02 02 03 10 10 10 03 02 02 02 02 02 02 02 02 02 02 02 02 02 02 02 02 03 10 10 03 02 02 02 00 
00 02 03 10 10 03 02 02 02 02 02 02 02 02 02 02 02 02 02 02 02 03 10 10 10 03 02 02 02 02 02 02 02 02 02 02 02 02 02 02 02 02 03 10 10 03 02 02 02 00 
00 02 03 10 10 03 02 02 02 02 02 02 02 02 02 02 02 02 02 02 02 03 10 10 10 03 02 02 02 02 02 02 02 02 02 02 02 02 02 02 02 02 03 10 10 03 02 02 02 00 
00 02 03 10 10 03 02 02 02 02 02 02 02 02 02 02 02 02 02 02 02 03 10 10 10 03 02 02 02 02 02 02 02 02 02 02 02 02 02 02 02 02 03 10 10 03 02 02 02 00 
00 02 03 10 10 03 02 02 02 02 02 02 02 02 02 02 02 02 02 02 02 03 10 10 10 03 02 02 02 02 02 02 02 02 02 02 02 02 02 02 02 02 03 10 10 03 02 02 02 00 
00 02 03 10 10 03 02 02 02 02 02 02 02 02 02 02 02 02 02 02 02 03 10 10 10 03 02 02 02 02 02 02 02 02 02 02 02 02 02 02 02 02 03 10 10 03 02 02 02 00 
00 02 03 10 10 03 02 02 02 02 02 02 02 02 02 02 02 02 02 02 02 03 10 10 10 03 02 02 02 02 02 02 02 02 02 02 02 02 02 02 03 03 03 10 10 03 03 03 02 00 
00 02 03 10 10 03 02 02 02 02 02 02 02 02 02 02 02 02 02 02 02 03 10 10 10 03 02 02 02 02 02 02 02 03 03 03 03 03 03 03 03 10 10 10 10 10 10 03 02 00 
00 02 03 10 10 03 02 02 02 02 02 02 02 02 02 02 02 02 02 02 02 03 10 10 10 03 03 03 03 03 03 03 03 03 03 03 03 03 03 03 03 10 10 10 10 10 10 03 02 00 
00 02 03 10 10 03 02 02 02 02 02 02 02 02 02 02 02 02 02 02 02 03 10 10 10 10 10 10 10 10 10 10 10 10 10 10 10 10 10 10 10 10 10 10 10 10 10 03 02 00 
00 02 03 10 10 03 02 02 02 02 02 02 02 02 02 02 02 02 02 02 02 03 10 10 10 10 10 10 10 10 10 10 10 10 10 10 10 10 10 10 10 10 10 10 10 10 10 03 02 00 
00 03 03 10 10 03 03 03 03 03 03 03 03 03 03 03 03 03 03 03 03 03 10 10 10 03 03 03 03 03 03 03 03 03 03 03 03 03 03 03 03 10 10 10 10 10 10 03 02 00 
00 10 10 10 10 10 10 10 10 10 10 10 10 10 10 10 10 10 10 10 10 10 10 10 10 03 02 02 02 02 02 02 02 02 02 02 02 02 02 02 03 10 10 10 10 10 10 03 02 00 
00 10 10 10 10 10 10 10 10 10 10 10 10 10 10 10 10 10 10 10 10 10 10 10 10 03 02 02 02 02 02 02 02 02 02 02 02 02 02 02 03 03 03 03 03 03 03 03 02 00 
09 10 10 10 10 10 10 03 03 03 03 03 03 03 03 03 03 03 03 03 03 03 03 03 03 03 02 02 02 02 02 02 02 02 02 02 02 02 02 02 02 02 02 02 02 02 02 02 02 00 
10 10 10 10 10 10 10 03 02 02 02 02 02 02 02 02 02 02 02 02 02 02 02 02 02 02 02 02 02 02 02 02 02 02 02 02 02 02 02 02 02 02 02 02 02 02 02 02 02 00 
10 10 10 10 10 10 10 03 02 02 02 02 02 02 02 02 02 02 02 02 02 02 02 02 02 02 02 02 02 02 02 02 02 02 02 02 02 02 02 02 02 02 02 02 02 02 02 02 02 00 
10 10 10 10 10 10 10 03 02 02 02 02 02 02 02 02 02 02 02 02 02 02 02 02 02 02 02 02 02 02 02 02 02 02 02 02 02 02 02 02 02 02 02 02 02 02 02 02 02 00 
09 10 10 10 10 10 10 03 02 02 02 02 02 02 02 02 02 02 02 02 02 02 02 02 02 02 02 02 02 02 02 02 02 02 02 02 02 02 02 02 02 02 02 02 02 02 02 02 02 00
00 00 00 00 00 00 00 00 00 00 00 00 00 00 00 00 00 00 00 00 00 00 00 00 00 00 00 00 00 00 00 00 00 00 00 00 00 00 00 00 00 00 00 00 00 00 00 00 00 00